 CAAACAAAC 
 AACAAACAA 
 AA     AA 
 C   C   C 
 AA CAC AA 
 AA
 AA